32212211323312333113111332321132222323132232212332323113213231323321133233123232
13331221222221332211132221133232223213221311213321121122331211213112112211333312
13133311231211332313223133232322321211221233333322232233213211122112212312133122
12223223221222222322111321231213212122332333222132232213332112331323312323111112
31331231312122213311311131112111331212312211221111333331331131123322233131332322
23322111312223123331332121321323312233313221231112233321132221312233333331121222
32123132112322123213111321111133333221221233212111311221331121322111232321213332
23223112121123312323311312131333312313113232232113312223232133212131312123111112
31312223233133311233113133123222123233211211232112133111323113313223322231313112
23121313131323321121223232332113131211333313321313233231322231311121222333212112
31331123323212223112333231211332122232331211223111223323213233113213321113332212
32313312123332112331211113113223222223211221221312332122133233131233313313123232
21223232231131313133121222233133311231332212312123131312313333312212222221333232
12133233211131131123331233333232312212311331323122323231221113212311312321112132
12313333313231323121333313223223331311312321222312133122332232122213213123223212
23311313233112312113323132323121332112332232213131321321323233132123331111231132
33323111312111332312222231121233233311322131312122311223221121323212322222331322
22221323223312232323322312333113222122323211213121221112332313222231312313222232
22323333121123322212222121132211131331123312223312223111322211322122113123322212
31332131222133121213232132322133213222133133131113112213311232222213211132112332
31133221133322321211232333321132311211312232133121311123132323131213231232213222
13212322311111323231332131231332233122122121222113123311311111333121211231123132
12213332123231223212211131113211133331221332113313332123222233323222312221323312
31233233311331133311222221323112313321121222113313131211211321213121111113113212
23131331133222232231213213231111122321323313232313131323131132322311222231322132
11121323211222122331222113312113111121113213321221213131211123113211213333313312
12232131133212333222113123333232311213133122311212332311222311231331311111321332
13232112323312131212112123313311221233232233322331213221121232323233121313131322
22321111121233132131311213113223223333221113311323311211221222232123211232322312
12313311121122331122313312223133213121233121231122222212221233111112323333132212
23233123323212133113322313113111122232322312121231311113232123112211111223222322
21211312132233313112332323212322333133121111323311132132233131222123333223323312
32113231123222221132221122211222132223333111212332323213113132311333122332211322
12231313233212233133313323133332223133313133131312323311323131211312232311312112
33222311232121212121133223331111321232113112112331132221231113331133313231222212
11123123113311133233321323131233311233221113312212123233311121223333333332333312
22121132311321132223332332212331213322113311312322111132112113312223332133131112
13333112223313223211133133231332213112133311331311211212331331232233222331332132
22123133233122211311321333222333332131212223231213311333131111321121312322121132
13331131223123121221122221311212323123311313311311232232233121111131122223133222
33313323113311212212111321233123133321213123121333312332323113333122112222212222
13121323232233131313131132113111231111213132122332331212323123321212221111223132
32233332133133312112331232231213213231212333213122322321212321311121311221331132
32121222112113221132323231113232212232232231223211222112132333232211233322112132
33121231131331113123332333111131111313333123223223222233133233232333232123123232
11223121113112111321213112112132223221312331221221323122113112123313231113131332
11111213322121131113223111213223222123133322233133121221111221233322312321313322
23133231212321221232123332211122133122331221333113132112322332331123331212321122
33322231212212231223223113322321133121121212111321211132212322212211233233133312
32121332223233113111133212113321131332313233232213221131211333313223333213331232
32323113312112231323233221233113322232313312322323232231111333212322313122311122
11132323313132321131323211332323113123211232111222332111113312211231232311231332
21122313131311322332211223321132211311221111131213211111123322212121211123232322
32311111211123322213212212323231112111212213231121233132331312133231113122121212
11332122232333312321222232133112321233212332122321212231312113132121233313123322
33133223322333132222232233333132311233223323212111223122211113221223323122232322
33333311133131123231113312131312123221212332323322332311132121132111211221112232
12113322323111111323122133212311113321121122223122121231323232221211131112132132
33323211223323232111111212332111332212112333133312112113132231311113223231122222
31113123333122223133221232323323323132321212111321113122122211222322111122233322
13332323111212311322223132223312123111313333322123112223221121332112323312313232
31331333222232131231222111233322133313311122321313313121311132323122221111322332
21221222112121221122122112221321222231123233211131331123222213121223231122312322
21322131133222231322322313122332323333232311213311121323131223213332221233221112
13233312313313332123111232121212313232313321221231311122123331331112222222311222
11333112232322113311211223121123212232331233221213311323232232122111132332112222
13232312321322221313321112121311131332113123212132312312113322233121113223111232
33131223221213221231121211323332231322211123331331121232312331233233231132113222
33231222333221123331112111221322122323232233332321332321131132333113333221231322
21232123121222123232112132312133232231311123132231231231312111122212212112332332
11221131133111231331331231321131323113133122333112231331232212112311223121132232
21322311122131112112231333233223331222122321211111311231332121113332333331131332
31313223321131311311112321121233223112313321222111131111131322232113111313231112
12322113231112131332123223122111231112223333323223231333211221323113322122222122
21133133231132331223321233233322111221223133113122222112123211223331321121322112
32121321331333333113331323321131321311231333211233322111213321311321231333211122
31312122232131113332331321321332113311221222322121331111322331211123233312111122
13332223231321311331323322212112111332113332221211211122133222111312132112132112
13312331221212222323332221112233111322122111312233222221332323121131213233233112
11111111111111111111111111111111111111111111111111111111111111111111111111111110